1111111111111111111111111111111111
1E000000000C0000000000000000010011
1010010100100000101001000000011101
1000100010101010101001000000011101
1P10000000000000110000000000001001
1111111111111111111111111111111111